{
	"tileset" : "chemin.png",
	"data" : [
		[1, 2, 3, 4, 2, 2, 2, 2, 2,  2,  2,  2,  2,  2,  2],
		[5, 6, 7, 8, 2, 2, 2, 2, 2,  2,  2,  2,  2,  2,  2],
		[9, 10, 11, 12, 2, 2, 2, 2, 2,  2,  2,  2,  2,  2,  2],
		[13, 14, 15, 16, 2, 2, 2, 2, 2,  2,  2,  2,  2,  2,  2],
		[2, 2, 2, 2, 2, 2, 2, 2, 2,  2,  2,  2,  2,  2,  2],
		[2, 2, 2, 2, 2, 2, 2, 2, 2,  2,  2,  2,  2,  2,  2],
		[2, 2, 2, 2, 2, 2, 2, 2,  2,  2,  2,  2,  2,  2,  2],
		[2, 2, 2, 2, 2, 2, 2, 2, 2, 2, 2, 2, 2, 2, 2],
		[2, 2, 2, 2, 2, 2, 2, 2, 2, 2, 2, 2, 2, 2, 2],
		[2, 2, 2, 2, 2, 2, 2, 2, 2,  2,  2,  2,  2,  2,  2],
		[2, 2, 2, 2, 5, 6, 7, 2, 5,  6,  7,  2,  2,  2,  2],
		[2, 2, 2, 2, 12, 10, 12, 10, 12,  10,  12,  2,  2,  2,  2],
		[2, 2, 2, 2, 13, 14, 15, 16, 13,  14,  15,  2,  2,  2,  2],
		[2, 2, 2, 2, 2, 2, 2, 2, 2,  2,  2,  2,  2,  2,  2],
		[2, 2, 2, 2, 2, 2, 2, 2, 2,  2,  2,  2,  2,  2,  2]
	],
	
	"terrain" : [
		[3, 2, 2, 2, 2, 2, 2, 2, 2, 2, 2, 2, 2, 2, 1],
		[3, 2, 2, 2, 2, 2, 2, 2, 2, 2, 2, 2, 2, 2, 1],
		[3, 3, 3, 3, 3, 3, 3, 3, 3, 3, 3, 3, 2, 2, 1],
		[3, 2, 2, 2, 2, 2, 2, 2, 2, 2, 2, 3, 2, 2, 1],
		[3, 2, 2, 2, 2, 2, 2, 2, 2, 2, 2, 3, 2, 2, 1],
		[3, 2, 2, 1, 1, 1, 1, 1, 1, 2, 2, 3, 2, 2, 2],
		[3, 2, 2, 2, 2, 2, 2, 2, 1, 2, 2, 3, 3, 2, 2],
		[3, 2, 2, 2, 2, 2, 2, 2, 1, 2, 2, 3, 3, 2, 2],
		[3, 3, 3, 3, 3, 3, 2, 2, 1, 2, 2, 3, 3, 2, 2],
		[3, 2, 2, 2, 2, 2, 2, 2, 1, 2, 2, 3, 2, 2, 2],
		[3, 2, 2, 2, 2, 2, 2, 2, 1, 2, 2, 2, 2, 2, 1],
		[3, 2, 2, 1, 1, 1, 1, 1, 1, 2, 2, 2, 2, 2, 1],
		[3, 2, 2, 2, 2, 2, 2, 2, 1, 1, 1, 1, 1, 1, 1],
		[3, 2, 2, 2, 2, 2, 2, 2, 2, 2, 2, 2, 2, 2, 2],
		[3, 3, 3, 3, 3, 3, 2, 2, 2, 2, 2, 2, 2, 2, 2]
	]

}
